:in_x=2
:in_y=6
:out_x=29
:out_y=8
:item=<door, 3, 12, 1, 0, 2>
:item=<door, 23, 6, 1, 1, 2>
AAAAAAAAAAAAAAAAAAAAAAAAAAAAAAAA
AAAAAAAAAAAAAAAAAAAAAAAAAAAAAAAA
AAAAAAAAAAAAAAAAAAAAAAAAAAAAAAAA
AAAAAAAAAAAAAAAAAAAAAAAAAAAAAAAA
AAAAAAAAAAAAAAAAAAAAAAAAAAAAAAAA
AAAAAAAAAAAAAAAAAAAAAAAAAAAAAAAA
AAAAAAAAAAAAAAAAFFFFFFFAAAAAAAAA
FFFFFFFFFFFAAAAAAAAAAAAAAABBBBBB
AAAAAAAAAAAAAAAAAAAAAAAABBBAAAAB
AAAAAAAAAAAAAAAAAAAAAABBBAAAAABB
AAAAAAAAAAAAAAAAAAAABBBBAAAAGBBB
AAAAAAAAAAAAAAAABBBBBAAAAAAABBBB
AAAAAAAAAAAAAAABBBBBBAAAAAAAAABB
BBBBBBBBBBBBBBBBBBBBBBBBBBBBBBBB
CCCCCCCCCCCCCCCCCCCCCCCCCCCCCCCC
CCCCCCCCCCCCCCCCCCCCCCCCCCCCCCCC
CCCCCCCCCCCCCCCCCCCCCCCCCCCCCCCC
CCCCCCCCCCCCCCCCCCCCCCCCCCCCCCCC