:in_x=2
:in_y=6
:out_x=31
:out_y=7
:item=<door, 14, 6, 1, 0, 0>
:item=<door, 25, 7, 1, 1, 0>
:item=<swap, 11, 10>
AAAAAAAAAAAAAAAAAAAAAAAAAAAAAAAA
AAAAAAAAAAAAAAAAAAAAAAAAAAAAAAAA
AAAAAAAAAAAAAAAAAAAAAAAAAAAAAAAA
AAAAAAAAAAAAAAAAAAAAAAAAAAAAAAAA
AAAAAAAAAAAAAAAAAAAAAAAAAAAAAAAA
AAAAAAAAAAAAAAAAAAAAAAAAAAAAAAAA
AAAAAAAAAAAAAAAAAAAAAAAAAAAAAAAA
AAAAAAAAAAAAAAAAAAAAAAAAAAAAAAAA
AAAAAAAAAAAAAAAAAAAAAAAAAAAAAAAA
AAAAAAAAAFFFFFFFAAAAAAAAAAAAAAAA
AAAAAAAAAAAAAAAAAAFFFFAAAAAAAAAA
AAAAAAAAAAAAAAAAAAAAAAAAAAAAAAGA
AAAAAAAAAAAAAAAAAAHHHHBBBBBBBBBB
BBBBBBBBBBBBBBBBBBBBBBBBBBBBBBBB
CCCCCCCCCCCCCCCCCCCCCCCCCCCCCCCC
CCCCCCCCCCCCCCCCCCCCCCCCCCCCCCCC
CCCCCCCCCCCCCCCCCCCCCCCCCCCCCCCC
CCCCCCCCCCCCCCCCCCCCCCCCCCCCCCCC