:in_x=2
:in_y=6
:out_x=31
:out_y=6
:item=<door, 7, 14, 1, 0, 0>
:item=<door, 25, 6, 1, 1, 0>
:item=<ladder, 10, 10, 4>
:item=<swap, 7, 6>
AAAAAAAAAAFAAAAAAAAAAAAAAAAAAAAA
AAAAAAAAAAFAAAAAAAAAAAAAAAAAAAAA
AAAAAAAAAAFAAAAAAAAAAAAAAAAAAAAA
AAAAAAAAAAFAAAAAAAAAAAAAAAAAAAAA
AAAAAAAAAAFAAAAAAAAAAAAAAAAAAAAA
FFFFFFFFFFFAAAAAAAAAAAAAAAAAAAAA
AAAAAAAAAAAAAAAAAAAAAAAAAAAAAAAA
AAAAAAAAAAAAAAAAAAAAAAAAAAAAAAAA
AAAAAAAAAAAAAAAAAAAAAAAAAAAAAAAA
AAAAAAAAAFFFFFFFAAAAAAAAAAAAAAAA
AAAAAAAAAAAAAAAAAAFFFFAAAAAAAAAA
AAAAAAAAAAAAAAAAAAAAAAAAAAAAAAAA
AAAAAAAAAAAAAAHHHAAAAAAAAAAAAAGA
BBBBBBBBBBBBBBBBBBBBBBBBBBBBBBBB
CCCCCCCCCCCCCCCCCCCCCCCCCCCCCCCC
CCCCCCCCCCCCCCCCCCCCCCCCCCCCCCCC
CCCCCCCCCCCCCCCCCCCCCCCCCCCCCCCC
CCCCCCCCCCCCCCCCCCCCCCCCCCCCCCCC