:in_x=2
:in_y=6
:out_x=31
:out_y=6
:item=<door, 7, 14, 1, 0, 0>
:item=<door, 30, 14, 1, 1, 0>
:item=<door, 27, 14, 2, 0, 2>
:item=<door, 16, 6, 2, 1, 2>
:item=<swap, 4, 6>
AAAAAAAAAAFAAAAAAAAAAFAAAAAAAAAA
AAAAAAAAAAFAAAAAAAAAAFAAAAAAAAAA
AAAAAAAAAAFAAAAAAAAAAFAAAAAAAAAA
AAAAAAAAAAFAAAAAAAAAAFAAAAAAAAAA
AAAAAAAAAAFAAAAAAAAAAFAAAAAAAAAA
FFFFFFFFFFFAAAAAAAAAAFFFFFFFFFFF
AAAAAAAAAAAAAAAAAAAAAAAAAAAAAAAA
AAAAAAAAAAAAAAAAAAAAAAAAAAAAAAAA
AAAAAAAAAAAAAAAAAAAAAAAAAAAAAAAA
AAAAAAAAAAAAAAAAAAAAAAAAAAAAAAAA
AAAAAAAAAAAAAAAAAAAAAAAAAAAAAAAA
AAAAAAAAAAAAAAAAAAAAAAAAAAAAAAAA
AAAAAAAAAAAHHHHAHHHHAAAAAAAAAAGA
BBBBBBBBBBBBBBBBBBBBBBBBBBBBBBBB
CCCCCCCCCCCCCCCCCCCCCCCCCCCCCCCC
CCCCCCCCCCCCCCCCCCCCCCCCCCCCCCCC
CCCCCCCCCCCCCCCCCCCCCCCCCCCCCCCC
CCCCCCCCCCCCCCCCCCCCCCCCCCCCCCCC