:in_x=2
:in_y=6
:out_x=29
:out_y=14
:item=<door, 4, 6, 1, 0, 2>
:item=<door, 4, 12, 1, 1, 2>
AAAAAAAAAAAAAAAAAAAAAAAAAAAAAAAA
AAAAAAAAAAAAAAAAAAAAAAAAAAAAAAAA
AAAAAAAAAAAAAAAAAAAAAAAAAAAAAAAA
AAAAAAAAAAAAAAAAAAAAAAAAAAAAAAAA
AAAAAAAAAAAAAAAAAAAAAAAAAAAAGAAA
AAAAAAAAAAAAAAAAAAAAAAAAAAAAAAAA
AAAAAAAAAAAAAAAAFFFFFFFAAAAAAAAA
FFFFFFFFFFFAAAAAAAAAAAAAAAAAAAAA
AAAAAAAAAAAAAAAAAAAAAAAAAAAAAAAA
AAAAAAAAAAAAAAAAAAAAAAAAAAAAAAAA
AAAAAAAAAAAAAAAAAAAAAAAAAAAAAAAA
AAAAAAAAAAAAAAAAAAAAAAAAAAAAAAAA
AAAAAAAAAAAAAAAAAAAAAAAAAAAAAAAA
BBBBBBBAAAAAABBBBBBBBBBBBBAAAAAA
CCCCCCCAAAAAACCCCCCCCCCCCCCAAAAA
CCCCCCCAAAAAACCCCCCCCCCCCCCCCAAA
CCCCCCCCAAAAACCCCCCCCCCCCCCCCCCA
CCCCCCCCCAAACCCCCCCCCCCCCCCCCCCC