:in_x=2
:in_y=16
:out_x=31
:out_y=6
AAAAAAAAAAAAAAAAAAAAAAAAAAAAAAAA
AAAAAAAAAAAAAAAAAAAAAAAAAAAAAAAA
AAAAAAAAAAAAAAAAAAAAAAAAAAAAAAAA
FFFFFFFAAAAAAAAAAAAAAAAAAAAAAAAA
AAAAAAAAAAAAAAAAAAAAAAAAAAAAAAAA
AAAAAAAAAAFFFFFFAAAAAAAAAAAAAAAA
AAAAAAAAAAAAAAAAAAAFFFFAAAAAAAAA
AAAAAAAAAAAAAAAAAAAAAAAAABBBAAAA
AAAAAAAAAAAAAAAAAAAAAAAAFBAAAAAA
AAAAAAAAAAAAAAAAAAAAAAABBBFFAAAA
AAAAAAAAAAAAAAAAAAAAAABAAAAAAAAA
AAAAAAAAAAAAAAAAAAAAABAAAAAAFFAA
AAAAAAAAAAAAAAAAAAAABAAAAAAAAAGA
BBBBBBBBBBBBBBBBBBBBBBBBBBBBBBBB
CCCCCCCCCCCCCCCCCCCCCCCCCCCCCCCC
CCCCCCCCCCCCCCCCCCCCCCCCCCCCCCCC
CCCCCCCCCCCCCCCCCCCCCCCCCCCCCCCC
CCCCCCCCCCCCCCCCCCCCCCCCCCCCCCCC