:in_x=2
:in_y=6
:out_x=31
:out_y=10
:<ladder, 29, 10, 3>
AAAAAAAAAAAAAAAAAAAAAAAAAAAAAAAA
AAAAAAAAAAAAAAAAAAAAAAAAAAAAAAAA
AAAAAAAAAAAAAAAAAAAAAAAAAAAAAAAA
AAAAAAAAAAAAAAAAAAAAAAAAAAAAAAAA
AAAAAAAAAAAAAAAAAAAAAAAAAAAAAAAA
AAAAAAAAAAAAAAAAAAAAAAAAAAAAAAAA
AAAAAAAAAAAAAAAAAAAAAAAAAFFFFFFF
AAAAAAAAAAAAAAAAAAAAAFFFAAAAAAAA
AAAAAAAAAAAAAAAAAAAAAAAAAAAAAAGA
AAAAAAAAAAAAAAFFFFFAAAAAAAAAAFFF
AAAAAAAAAAAAAAAAAAAAAAAAAAAAAAAA
AAAAAAFFFFFFAAAAAAAAAAAAAAAAAAAA
AAAAAAAAAAAAAAAAAAAAAAAAAAAAAAAA
BBBBBBBBBBBBBBBBBBBBBBBBBBBBBBBB
CCCCCCCCCCCCCCCCCCCCCCCCCCCCCCCC
CCCCCCCCCCCCCCCCCCCCCCCCCCCCCCCC
CCCCCCCCCCCCCCCCCCCCCCCCCCCCCCCC
CCCCCCCCCCCCCCCCCCCCCCCCCCCCCCCC