:in_x=2
:in_y=12
:out_x=31
:out_y=6
:item=<ladder, 5, 6, 6>
AAAAAAAAFAAAAAAAAAAAAAAAAAAAAAAA
AAAAAAAAFAAAAAAAAAAAAAAAAAAAAAAA
AAAAAAAAFAAAAAAAAAAAAAAAAAAAAAAA
AAAAAAAAFAAAAAAAAAAAAAAAAAAAAAAA
AAAAAAAAFAAAAAAAAAAAAAAAAAAAAAAA
AAAAAAAAFAAAAAAAAAAAAAAAAAAAAAAA
AAAAAAAAFAAAAAAAAAAAAAAAAAAAAAAA
FFFFFFFFFAAAAAAAAAAAAAAAAAAAAAAA
AAAAAAAAAAAAAAAAAAAAAAAAAAAAAAAA
AAAAAAAAAAAAAAAAAAAAAAAAAAAAAAAA
AAAAAAAAAAAAAAAAAAAAAAAAAAAAAAAA
AAAAAAAAAAAAAAAAAAAAAAAAAAAAAAAA
AAAAAAAAAAAAAAAAAAAAAAAAAAAAAAGA
BBBBBBBBBBBBBBBBBBBBBBBBBBBBBBBB
CCCCCCCCCCCCCCCCCCCCCCCCCCCCCCCC
CCCCCCCCCCCCCCCCCCCCCCCCCCCCCCCC
CCCCCCCCCCCCCCCCCCCCCCCCCCCCCCCC
CCCCCCCCCCCCCCCCCCCCCCCCCCCCCCCC